F 40,40,40
C 135,206,235

NO textures/bombardiro1.xpm
SO textures/paper.xpm
WE textures/shit.xpm
EA textures/exit_open.xpm

111111111111111111111111
100000000000000000000001
100000000000000000000001
100011111111111111100001
100010000000000000100001
100010000000000000100001
100010000000000000100001
100010000N00000000100001
100010000000000000100001
100010000000000000100001
100011111111111111100001
100000000000000000000001
100000000000000000000001
111111111111111111111111
