NO ./path_no
SO ./path_so
WE ./path_we
WE ./path_we
EA ./path_ea
F 220,100,0
C 220,200,0

11111
1N001
11111