NO ./path_no
SO ./path_so
WE ./path_we
EA ./path_ea
F 220,100,0
C 225,30,0

111111
1N0001
10 001
111111