NO ./path_to_the_north_texture
SO ./path_to_the_south_texture
F 220,100,0
C 220,100,0

111111
100N01
101101
111111
